GGLGEGGG LL
WGGGWG GWLG
BELBG BBGBW
BGEG GGLGGG
GLGGBEEBW G